SSSSSSSSSSSSSSSSSSS________
SMS_____________SMS________
SSS___SSS_SSS___SSS________
S____SHHHSHHHS____S________
S___SHHHHHHHHHS___S________
S___SHHHHHHHHHS___STTTTTTnn
S___SHHHHVHHHHS__________Wn
S____SHHHHHHHS_____TTTTTTnn
S_____SHHHHHS_____S________
S______SHHHS______S________
S_______SHS_______S________
S________B________S________
SSS_____________SSS________
SMS_____________SMS________
SSSSSSSSSSSSSSSSSSS________