SSSSSSSSSSSSSSSSSSSSS
S+_____B__M____B___HS
S_T_T_T_T_T_T_T_T_T_S
S_B____B_____B_____BS
S_T_T_T_T_T_TBT_T_T_S
S____B___________B__S
S_T_T_T_T_TBT_T_T_T_S
SB____B____B________S
S_TBT_T_T_T_T_TBT_T>S
SV__B________B___n__S
SSSSSSSSSSSSSSSSSSSSS