_V__SBS__S__M__
____SSS_KSSSSSS
____MM___S_____
_TBT_____S_____
_TTT__+-_B_____
__MMMM___S__n__
_TBT_____S_____