_____H___n__
SSS_S_SSSS__
B___SBS__SM_
____SBS__S__
_B__SSS_KS__
___M_____S__
_TBT_____S__
_TTT__+-_B__
_________B__
BSSSSBBSSSB_
_V_____M____
___<___>_S__
